public const string UdcIdOperacion = "OPERACION";
public const string UdcIdApellidoCasada = "APELLIDO_CASADA";
public const string UdcIdConocidoComo = "CONOCIDO_COMO";
public const string UdcIdParametroUltimus = "PARAMETRO_ULTIMUS";
public const string UdcIdProductoBancario = "PRODUCTO_BANCARIO";
public const string UdcIdProductoMoneda = "PRODUCTO_MONEDA";
public const string UdcIdSeguroSocial = "SEGURO_SOCIAL";
public const string UdcIdFechaVencimientoId = "FECHA_VENCIMIENTO_ID";
public const string UdcIdSucursalGestion = "SUCURSAL_GESTION";
public const string UdcIdEjecutivoContacto = "EJECUTIVO_CONTACTO";
public const string UdcIdRazonComercial = "RAZON_COMERCIAL";
public const string UdcIdEspecifiquePais = "ESPECIFIQUE_PAIS";
public const string UdcIdPersonaContacto = "PERSONA_CONTACTO";
public const string UdcIdCatRiesgoSugef = "CAT_RIESGO_SUGEF";
public const string UdcIdLineaNegocio = "LINEA_NEGOCIO";
public const string UdcIdSubSegmento = "SUB_SEGMENTO";
public const string UdcIdActividadPrincipal = "ACTIVIDAD_PRINCIPAL";
public const string UdcIdActividadDolarMensual = "ACTIVIDAD_DOLAR_MENSUAL";
public const string UdcIdInfoFinanRespActividad = "INFO_FINAN_RESP_ACTIVIDAD";
public const string UdcIdOtrosTiposDocsFinan = "OTROS_TIPOS_DOCS_FINAN";
public const string UdcIdSubSector1 = "SUB_SECTOR1";
public const string UdcIdSubSector2 = "SUB_SECTOR2";
public const string UdcIdSubSector3 = "SUB_SECTOR3";
public const string UdcIdTipoPlanilla = "TIPO_PLANILLA";
public const string UdcIdCantidadEmpleados = "CANTIDAD_EMPLEADOS";
public const string UdcIdActualizacionKYC = "ACTUALIZACION_K_Y_C";
public const string UdcIdActualizaciontransaccional = "ACTUALIZACIONTRANSACCIONAL";
public const string UdcIdActualizacionBdBPerfil = "ACTUALIZACION_BD_B_PERFIL";
public const string UdcIdActualizacionBdETransaccional = "ACTUALIZACION_BD_E_TRANSACCIONAL";
public const string UdcIdContratoUnico = "CONTRATO_UNICO";
public const string UdcIdCamBasicNoActualizacionKYC = "CAM_BASIC_NO_ACTUALIZACION_K_Y_C";
public const string UdcIdClienteCorredoraAseguradora = "CLIENTE_CORREDORA_ASEGURADORA";
public const string UdcIdBarrio = "BARRIO";
public const string UdcIdOtrasSenas = "OTRAS_SENAS";
public const string UdcIdPaginaWeb = "PAGINA_WEB";
public const string UdcIdCodArea = "COD_AREA";
public const string UdcIdNumTelefono = "NUM_TELEFONO";
public const string UdcIdExtension = "EXTENSION";
public const string UdcIdTipoMoneda = "TIPO_MONEDA";
public const string UdcIdTipoEmpleo = "TIPO_EMPLEO";
public const string UdcIdNumeroIdDepende = "NUMERO_ID_DEPENDE";
public const string UdcIdTipoIdDepende = "TIPO_ID_DEPENDE";
public const string UdcIdZona = "ZONA";
public const string UdcIdApartadoPostal = "APARTADO_POSTAL";
public const string UdcIdNombreContacto = "NOMBRE_CONTACTO";
public const string UdcIdApellidoPaterno = "APELLIDO_PATERNO";
public const string UdcIdApellidoMaterno = "APELLIDO_MATERNO";
public const string UdcIdCargoContacto = "CARGO_CONTACTO";
public const string UdcIdProductoContacto = "PRODUCTO_CONTACTO";
public const string UdcIdNumTelefonosContactoOtro = "NUM_TELEFONOS_CONTACTO_OTRO";
public const string UdcIdFechaVencimientoIdJuridicaLegal = "FECHA_VENCIMIENTO_ID_JURIDICA_LEGAL";
public const string UdcIdFechaConstitucionLegal = "FECHA_CONSTITUCION_LEGAL";
public const string UdcIdCapitalSocialLegal = "CAPITAL_SOCIAL_LEGAL";
public const string UdcIdEmpresaVigenteLegal = "EMPRESA_VIGENTE_LEGAL";
public const string UdcIdPatrimonioLegal = "PATRIMONIO_LEGAL";
public const string UdcIdMonedaPatrimonioLegal = "MONEDA_PATRIMONIO_LEGAL";
public const string UdcIdTipoIdLegal = "TIPO_ID_LEGAL";
public const string UdcIdNumIdentificacionLegal = "NUM_IDENTIFICACION_LEGAL";
public const string UdcIdSexoLegal = "SEXO_LEGAL";
public const string UdcIdNombreLegal = "NOMBRE_LEGAL";
public const string UdcIdPrimerApellidoLegal = "PRIMER_APELLIDO_LEGAL";
public const string UdcIdSegundoApellidoLegal = "SEGUNDO_APELLIDO_LEGAL";
public const string UdcIdApellidoCasadaLegal = "APELLIDO_CASADA_LEGAL";
public const string UdcIdFechaNacimientoLegal = "FECHA_NACIMIENTO_LEGAL";
public const string UdcIdCodigoProfesionLegal = "CODIGO_PROFESION_LEGAL";
public const string UdcIdNacionalidadLegal = "NACIONALIDAD_LEGAL";
public const string UdcIdPersonaAsalariadaLegal = "PERSONA_ASALARIADA_LEGAL";
public const string UdcIdPApellidoSocio = "P_APELLIDO_SOCIO";
public const string UdcIdSApellidoSocio = "S_APELLIDO_SOCIO";
public const string UdcIdNombreSocio = "NOMBRE_SOCIO";
public const string UdcIdPorcentajePartSocio = "PORCENTAJE_PART_SOCIO";
public const string UdcIdNombreRP = "NOMBRE_R_P";
public const string UdcIdApellidoPaternoRP = "APELLIDO_PATERNO_R_P";
public const string UdcIdApellidoMaternoRP = "APELLIDO_MATERNO_R_P";
public const string UdcIdNumTelefonoDomRP = "NUM_TELEFONO_DOM_R_P";
public const string UdcIdNumTelefonoTrabRP = "NUM_TELEFONO_TRAB_R_P";
public const string UdcIdNumTelefonoOtroRP = "NUM_TELEFONO_OTRO_R_P";
public const string UdcIdTipoParentescoRP = "TIPO_PARENTESCO_R_P";
public const string UdcIdCiudadaniaNacionalidad = "CIUDADANIA_NACIONALIDAD";
public const string UdcIdImpactadoFatca = "IMPACTADO_FATCA";
public const string UdcIdEmpresaRegistradaFatca = "EMPRESA_REGISTRADA_FATCA";
public const string UdcIdNumGIIN = "NUM_G_I_I_N";
public const string UdcIdEmpresaSucFilSub = "EMPRESA_SUC_FIL_SUB";
public const string UdcIdCasaMatriz = "CASA_MATRIZ";
public const string UdcIdNombreCasaMatriz = "NOMBRE_CASA_MATRIZ";
public const string UdcIdNumIdCasaMatriz = "NUM_ID_CASA_MATRIZ";
public const string UdcIdNumEIN = "NUM_E_I_N";
public const string UdcIdEmpresaTributacion = "EMPRESA_TRIBUTACION";
public const string UdcIdEmpresaBeneficiarios = "EMPRESA_BENEFICIARIOS";
public const string UdcIdEmpresaAccionistas = "EMPRESA_ACCIONISTAS";
public const string UdcIdEmpresaImpactadaFatca = "EMPRESA_IMPACTADA_FATCA";
public const string UdcIdEmpresaSociosPais = "EMPRESA_SOCIOS_PAIS";
public const string UdcIdTipoOperaciones = "TIPO_OPERACIONES";
public const string UdcIdGEconomicoCobis = "G_ECONOMICO_COBIS";
public const string UdcIdGIESugef = "G_I_E_SUGEF";
public const string UdcIdGCalificacion = "G_CALIFICACION";
public const string UdcIdCategoriaSugef = "CATEGORIA_SUGEF";
public const string UdcIdCatAntSugef = "CAT_ANT_SUGEF";
public const string UdcIdBloqSugef = "BLOQ_SUGEF";
public const string UdcIdNumOficio = "NUM_OFICIO";
public const string UdcIdFechaRiesgo = "FECHA_RIESGO";
public const string UdcIdCatBloqueada = "CAT_BLOQUEADA";
public const string UdcIdCapacidadPago = "CAPACIDAD_PAGO";
public const string UdcIdCondDeudor = "COND_DEUDOR";
public const string UdcIdGeneraDivisas = "GENERA_DIVISAS";
public const string UdcIdCriterioRiesgo = "CRITERIO_RIESGO";
public const string UdcIdCatRiesgoBanistmo = "CAT_RIESGO_BANISTMO";
public const string UdcIdCatNIC39 = "CAT_N_I_C39";
public const string UdcIdPagoHistorico = "PAGO_HISTORICO";
public const string UdcIdReservaNIC39 = "RESERVA_N_I_C39";
public const string UdcIdCalifIntenacional = "CALIF_INTENACIONAL";
public const string UdcIdEmpresaCalificadora = "EMPRESA_CALIFICADORA";
public const string UdcIdTipoPlazo = "TIPO_PLAZO";
public const string UdcIdCalifRiesgo = "CALIF_RIESGO";
public const string UdcIdRiesgoCambiarioDeudor = "RIESGO_CAMBIARIO_DEUDOR";
public const string UdcIdIndicadorDeclaraRenta = "INDICADOR_DECLARA_RENTA";
public const string UdcIdCuotasNoReguladasCSD = "CUOTAS_NO_REGULADAS_C_S_D";
public const string UdcIdIndicadorCSD = "INDICADOR_C_S_D";
public const string UdcIdMontoIngreso = "MONTO_INGRESO";
public const string UdcIdOtrasSenales = "OTRAS_SENALES";
public const string UdcIdTipoVivienda = "TIPO_VIVIENDA";
public const string UdcIdCodigoTienda = "CODIGO_TIENDA";
public const string UdcIdCodigoSucursal = "CODIGO_SUCURSAL";
public const string UdcIdIpDispositivo = "IP_DISPOSITIVO";
public const string UdcIdActividadLaboral = "ACTIVIDAD_LABORAL";
public const string UdcIdSICCode = "S_I_C_CODE";
public const string UdcIdCodigoCIIU = "CODIGO_C_I_I_U";
public const string UdcIdMarca = "MARCA";
public const string UdcIdProgramaLealtad = "PROGRAMA_LEALTAD";
public const string UdcIdTipoTarjeta = "TIPO_TARJETA";
public const string UdcIdViajeroFrecuente = "VIAJERO_FRECUENTE";
